"filename", "language", "SCSS", "TypeScript", "HTML", "XML", "comment", "blank", "total"
"d:\JS\light-store\src\_mixins.scss", "SCSS", 32, 0, 0, 0, 0, 5, 37
"d:\JS\light-store\src\_variables.scss", "SCSS", 4, 0, 0, 0, 0, 1, 5
"d:\JS\light-store\src\app\app-routing.module.ts", "TypeScript", 0, 41, 0, 0, 0, 6, 47
"d:\JS\light-store\src\app\app.component.html", "HTML", 0, 0, 3, 0, 0, 1, 4
"d:\JS\light-store\src\app\app.component.scss", "SCSS", 0, 0, 0, 0, 0, 1, 1
"d:\JS\light-store\src\app\app.component.spec.ts", "TypeScript", 0, 31, 0, 0, 0, 5, 36
"d:\JS\light-store\src\app\app.component.ts", "TypeScript", 0, 8, 0, 0, 0, 3, 11
"d:\JS\light-store\src\app\app.module.ts", "TypeScript", 0, 23, 0, 0, 0, 4, 27
"d:\JS\light-store\src\app\modules\admins\admins-routing.module.ts", "TypeScript", 0, 21, 0, 0, 0, 4, 25
"d:\JS\light-store\src\app\modules\admins\admins.module.ts", "TypeScript", 0, 35, 0, 0, 0, 4, 39
"d:\JS\light-store\src\app\modules\admins\components\admin-header\admin-header.component.html", "HTML", 0, 0, 21, 0, 0, 1, 22
"d:\JS\light-store\src\app\modules\admins\components\admin-header\admin-header.component.scss", "SCSS", 0, 0, 0, 0, 0, 1, 1
"d:\JS\light-store\src\app\modules\admins\components\admin-header\admin-header.component.ts", "TypeScript", 0, 18, 0, 0, 0, 4, 22
"d:\JS\light-store\src\app\modules\admins\components\employee-item\employee-item.component.html", "HTML", 0, 0, 5, 0, 0, 1, 6
"d:\JS\light-store\src\app\modules\admins\components\employee-item\employee-item.component.scss", "SCSS", 8, 0, 0, 0, 0, 3, 11
"d:\JS\light-store\src\app\modules\admins\components\employee-item\employee-item.component.ts", "TypeScript", 0, 14, 0, 0, 0, 3, 17
"d:\JS\light-store\src\app\modules\admins\components\warehouse-item\warehouse-item.component.html", "HTML", 0, 0, 18, 0, 0, 3, 21
"d:\JS\light-store\src\app\modules\admins\components\warehouse-item\warehouse-item.component.scss", "SCSS", 35, 0, 0, 0, 1, 8, 44
"d:\JS\light-store\src\app\modules\admins\components\warehouse-item\warehouse-item.component.ts", "TypeScript", 0, 14, 0, 0, 0, 3, 17
"d:\JS\light-store\src\app\modules\admins\guards\admin.guard.ts", "TypeScript", 0, 20, 0, 0, 0, 4, 24
"d:\JS\light-store\src\app\modules\admins\models\dto\create-employee-dto.ts", "TypeScript", 0, 8, 0, 0, 0, 1, 9
"d:\JS\light-store\src\app\modules\admins\models\dto\create-warehouse-dto.ts", "TypeScript", 0, 5, 0, 0, 0, 1, 6
"d:\JS\light-store\src\app\modules\admins\models\dto\update-warehouse-dto.ts", "TypeScript", 0, 6, 0, 0, 0, 1, 7
"d:\JS\light-store\src\app\modules\admins\models\employee.ts", "TypeScript", 0, 7, 0, 0, 0, 2, 9
"d:\JS\light-store\src\app\modules\admins\pages\admin-page\admin-page.component.html", "HTML", 0, 0, 9, 0, 0, 1, 10
"d:\JS\light-store\src\app\modules\admins\pages\admin-page\admin-page.component.scss", "SCSS", 0, 0, 0, 0, 0, 1, 1
"d:\JS\light-store\src\app\modules\admins\pages\admin-page\admin-page.component.ts", "TypeScript", 0, 12, 0, 0, 0, 2, 14
"d:\JS\light-store\src\app\modules\admins\services\employee.service.ts", "TypeScript", 0, 34, 0, 0, 0, 4, 38
"d:\JS\light-store\src\app\modules\admins\services\warehouse.service.ts", "TypeScript", 0, 52, 0, 0, 0, 8, 60
"d:\JS\light-store\src\app\modules\admins\tabs\employee-editor-tab\employee-editor-tab.component.html", "HTML", 0, 0, 54, 0, 0, 8, 62
"d:\JS\light-store\src\app\modules\admins\tabs\employee-editor-tab\employee-editor-tab.component.scss", "SCSS", 4, 0, 0, 0, 0, 1, 5
"d:\JS\light-store\src\app\modules\admins\tabs\employee-editor-tab\employee-editor-tab.component.ts", "TypeScript", 0, 98, 0, 0, 2, 8, 108
"d:\JS\light-store\src\app\modules\admins\tabs\employees-tab\employees-tab.component.html", "HTML", 0, 0, 15, 0, 0, 1, 16
"d:\JS\light-store\src\app\modules\admins\tabs\employees-tab\employees-tab.component.scss", "SCSS", 8, 0, 0, 0, 0, 3, 11
"d:\JS\light-store\src\app\modules\admins\tabs\employees-tab\employees-tab.component.ts", "TypeScript", 0, 25, 0, 0, 0, 7, 32
"d:\JS\light-store\src\app\modules\admins\tabs\warehouses-editor-tab\warehouses-editor-tab.component.html", "HTML", 0, 0, 36, 0, 0, 6, 42
"d:\JS\light-store\src\app\modules\admins\tabs\warehouses-editor-tab\warehouses-editor-tab.component.scss", "SCSS", 0, 0, 0, 0, 0, 1, 1
"d:\JS\light-store\src\app\modules\admins\tabs\warehouses-editor-tab\warehouses-editor-tab.component.ts", "TypeScript", 0, 103, 0, 0, 2, 18, 123
"d:\JS\light-store\src\app\modules\admins\tabs\warehouses-tab\warehouses-tab.component.html", "HTML", 0, 0, 12, 0, 0, 1, 13
"d:\JS\light-store\src\app\modules\admins\tabs\warehouses-tab\warehouses-tab.component.scss", "SCSS", 0, 0, 0, 0, 0, 1, 1
"d:\JS\light-store\src\app\modules\admins\tabs\warehouses-tab\warehouses-tab.component.ts", "TypeScript", 0, 32, 0, 0, 0, 7, 39
"d:\JS\light-store\src\app\modules\customers\components\cart-item\cart-item.component.html", "HTML", 0, 0, 16, 0, 0, 1, 17
"d:\JS\light-store\src\app\modules\customers\components\cart-item\cart-item.component.scss", "SCSS", 37, 0, 0, 0, 0, 8, 45
"d:\JS\light-store\src\app\modules\customers\components\cart-item\cart-item.component.ts", "TypeScript", 0, 23, 0, 0, 0, 4, 27
"d:\JS\light-store\src\app\modules\customers\components\modal-please-signup\modal-please-signup.component.html", "HTML", 0, 0, 10, 0, 0, 1, 11
"d:\JS\light-store\src\app\modules\customers\components\modal-please-signup\modal-please-signup.component.scss", "SCSS", 0, 0, 0, 0, 0, 1, 1
"d:\JS\light-store\src\app\modules\customers\components\modal-please-signup\modal-please-signup.component.ts", "TypeScript", 0, 20, 0, 0, 0, 6, 26
"d:\JS\light-store\src\app\modules\customers\components\modal-product-remains\modal-product-remains.component.html", "HTML", 0, 0, 15, 0, 0, 1, 16
"d:\JS\light-store\src\app\modules\customers\components\modal-product-remains\modal-product-remains.component.scss", "SCSS", 13, 0, 0, 0, 0, 2, 15
"d:\JS\light-store\src\app\modules\customers\components\modal-product-remains\modal-product-remains.component.ts", "TypeScript", 0, 33, 0, 0, 0, 8, 41
"d:\JS\light-store\src\app\modules\customers\components\order-item\order-item.component.html", "HTML", 0, 0, 31, 0, 0, 1, 32
"d:\JS\light-store\src\app\modules\customers\components\order-item\order-item.component.scss", "SCSS", 45, 0, 0, 0, 0, 10, 55
"d:\JS\light-store\src\app\modules\customers\components\order-item\order-item.component.ts", "TypeScript", 0, 22, 0, 0, 0, 4, 26
"d:\JS\light-store\src\app\modules\customers\components\product-availability\product-availability.component.html", "HTML", 0, 0, 14, 0, 0, 1, 15
"d:\JS\light-store\src\app\modules\customers\components\product-availability\product-availability.component.scss", "SCSS", 4, 0, 0, 0, 0, 1, 5
"d:\JS\light-store\src\app\modules\customers\components\product-availability\product-availability.component.ts", "TypeScript", 0, 13, 0, 0, 0, 3, 16
"d:\JS\light-store\src\app\modules\customers\components\product-card\product-card.component.html", "HTML", 0, 0, 33, 0, 0, 1, 34
"d:\JS\light-store\src\app\modules\customers\components\product-card\product-card.component.scss", "SCSS", 14, 0, 0, 0, 0, 4, 18
"d:\JS\light-store\src\app\modules\customers\components\product-card\product-card.component.ts", "TypeScript", 0, 27, 0, 0, 0, 7, 34
"d:\JS\light-store\src\app\modules\customers\customers-routing.module.ts", "TypeScript", 0, 31, 0, 0, 0, 5, 36
"d:\JS\light-store\src\app\modules\customers\customers.module.ts", "TypeScript", 0, 47, 0, 0, 0, 4, 51
"d:\JS\light-store\src\app\modules\customers\guards\customer.guard.ts", "TypeScript", 0, 20, 0, 0, 0, 4, 24
"d:\JS\light-store\src\app\modules\customers\models\cart-item.ts", "TypeScript", 0, 7, 0, 0, 0, 1, 8
"d:\JS\light-store\src\app\modules\customers\models\customer.ts", "TypeScript", 0, 4, 0, 0, 0, 2, 6
"d:\JS\light-store\src\app\modules\customers\models\dtos\cart-item-dto.ts", "TypeScript", 0, 4, 0, 0, 0, 1, 5
"d:\JS\light-store\src\app\modules\customers\models\dtos\create-customer-dto.ts", "TypeScript", 0, 8, 0, 0, 0, 1, 9
"d:\JS\light-store\src\app\modules\customers\models\dtos\create-delivery-information-dto.ts", "TypeScript", 0, 4, 0, 0, 0, 1, 5
"d:\JS\light-store\src\app\modules\customers\models\dtos\create-order-dto.ts", "TypeScript", 0, 7, 0, 0, 0, 2, 9
"d:\JS\light-store\src\app\modules\customers\models\dtos\customer-signup-response-dto.ts", "TypeScript", 0, 7, 0, 0, 0, 2, 9
"d:\JS\light-store\src\app\modules\customers\models\dtos\product-in-order-dto.ts", "TypeScript", 0, 4, 0, 0, 0, 1, 5
"d:\JS\light-store\src\app\modules\customers\models\dtos\update-customer-dto.ts", "TypeScript", 0, 5, 0, 0, 0, 1, 6
"d:\JS\light-store\src\app\modules\customers\models\order-item.ts", "TypeScript", 0, 12, 0, 0, 0, 3, 15
"d:\JS\light-store\src\app\modules\customers\models\product-in-catalog.ts", "TypeScript", 0, 4, 0, 0, 0, 2, 6
"d:\JS\light-store\src\app\modules\customers\pages\cart-page\cart-page.component.html", "HTML", 0, 0, 36, 0, 0, 2, 38
"d:\JS\light-store\src\app\modules\customers\pages\cart-page\cart-page.component.scss", "SCSS", 66, 0, 0, 0, 0, 8, 74
"d:\JS\light-store\src\app\modules\customers\pages\cart-page\cart-page.component.ts", "TypeScript", 0, 55, 0, 0, 0, 9, 64
"d:\JS\light-store\src\app\modules\customers\pages\customer-base-layout\customer-base-layout.component.html", "HTML", 0, 0, 4, 0, 0, 1, 5
"d:\JS\light-store\src\app\modules\customers\pages\customer-base-layout\customer-base-layout.component.scss", "SCSS", 0, 0, 0, 0, 0, 1, 1
"d:\JS\light-store\src\app\modules\customers\pages\customer-base-layout\customer-base-layout.component.ts", "TypeScript", 0, 8, 0, 0, 0, 3, 11
"d:\JS\light-store\src\app\modules\customers\pages\customer-page\customer-page.component.html", "HTML", 0, 0, 6, 0, 0, 1, 7
"d:\JS\light-store\src\app\modules\customers\pages\customer-page\customer-page.component.scss", "SCSS", 0, 0, 0, 0, 0, 1, 1
"d:\JS\light-store\src\app\modules\customers\pages\customer-page\customer-page.component.ts", "TypeScript", 0, 19, 0, 0, 0, 5, 24
"d:\JS\light-store\src\app\modules\customers\pages\order-creating-page\order-creating-page.component.html", "HTML", 0, 0, 39, 0, 0, 1, 40
"d:\JS\light-store\src\app\modules\customers\pages\order-creating-page\order-creating-page.component.scss", "SCSS", 67, 0, 0, 0, 0, 8, 75
"d:\JS\light-store\src\app\modules\customers\pages\order-creating-page\order-creating-page.component.ts", "TypeScript", 0, 129, 0, 0, 0, 21, 150
"d:\JS\light-store\src\app\modules\customers\pages\product-details-page\product-details-page.component.html", "HTML", 0, 0, 47, 0, 0, 1, 48
"d:\JS\light-store\src\app\modules\customers\pages\product-details-page\product-details-page.component.scss", "SCSS", 44, 0, 0, 0, 0, 9, 53
"d:\JS\light-store\src\app\modules\customers\pages\product-details-page\product-details-page.component.ts", "TypeScript", 0, 53, 0, 0, 0, 10, 63
"d:\JS\light-store\src\app\modules\customers\pages\products-page\products-page.component.html", "HTML", 0, 0, 29, 0, 0, 1, 30
"d:\JS\light-store\src\app\modules\customers\pages\products-page\products-page.component.scss", "SCSS", 23, 0, 0, 0, 0, 6, 29
"d:\JS\light-store\src\app\modules\customers\pages\products-page\products-page.component.ts", "TypeScript", 0, 92, 0, 0, 0, 16, 108
"d:\JS\light-store\src\app\modules\customers\pages\registration-page\registration-page.component.html", "HTML", 0, 0, 47, 0, 0, 8, 55
"d:\JS\light-store\src\app\modules\customers\pages\registration-page\registration-page.component.scss", "SCSS", 4, 0, 0, 0, 0, 1, 5
"d:\JS\light-store\src\app\modules\customers\pages\registration-page\registration-page.component.ts", "TypeScript", 0, 97, 0, 0, 2, 8, 107
"d:\JS\light-store\src\app\modules\customers\services\cart.service.ts", "TypeScript", 0, 94, 0, 0, 0, 13, 107
"d:\JS\light-store\src\app\modules\customers\services\customer.service.ts", "TypeScript", 0, 82, 0, 0, 0, 11, 93
"d:\JS\light-store\src\app\modules\customers\services\local-cart.service.ts", "TypeScript", 0, 17, 0, 0, 0, 6, 23
"d:\JS\light-store\src\app\modules\customers\services\order.service.ts", "TypeScript", 0, 23, 0, 0, 0, 4, 27
"d:\JS\light-store\src\app\modules\customers\tabs\orders-tab\orders-tab.component.html", "HTML", 0, 0, 1, 0, 0, 1, 2
"d:\JS\light-store\src\app\modules\customers\tabs\orders-tab\orders-tab.component.scss", "SCSS", 0, 0, 0, 0, 0, 1, 1
"d:\JS\light-store\src\app\modules\customers\tabs\orders-tab\orders-tab.component.ts", "TypeScript", 0, 8, 0, 0, 0, 3, 11
"d:\JS\light-store\src\app\modules\customers\tabs\personal-tab\personal-tab.component.html", "HTML", 0, 0, 48, 0, 0, 6, 54
"d:\JS\light-store\src\app\modules\customers\tabs\personal-tab\personal-tab.component.scss", "SCSS", 0, 0, 0, 0, 0, 1, 1
"d:\JS\light-store\src\app\modules\customers\tabs\personal-tab\personal-tab.component.ts", "TypeScript", 0, 88, 0, 0, 2, 13, 103
"d:\JS\light-store\src\app\modules\employees\components\employee-header\employee-header.component.html", "HTML", 0, 0, 21, 0, 0, 1, 22
"d:\JS\light-store\src\app\modules\employees\components\employee-header\employee-header.component.scss", "SCSS", 0, 0, 0, 0, 0, 1, 1
"d:\JS\light-store\src\app\modules\employees\components\employee-header\employee-header.component.ts", "TypeScript", 0, 18, 0, 0, 0, 4, 22
"d:\JS\light-store\src\app\modules\employees\components\product-in-adding\product-in-adding.component.html", "HTML", 0, 0, 13, 0, 0, 1, 14
"d:\JS\light-store\src\app\modules\employees\components\product-in-adding\product-in-adding.component.scss", "SCSS", 28, 0, 0, 0, 0, 6, 34
"d:\JS\light-store\src\app\modules\employees\components\product-in-adding\product-in-adding.component.ts", "TypeScript", 0, 23, 0, 0, 0, 4, 27
"d:\JS\light-store\src\app\modules\employees\components\product-item\product-item.component.html", "HTML", 0, 0, 9, 0, 0, 1, 10
"d:\JS\light-store\src\app\modules\employees\components\product-item\product-item.component.scss", "SCSS", 17, 0, 0, 0, 0, 5, 22
"d:\JS\light-store\src\app\modules\employees\components\product-item\product-item.component.ts", "TypeScript", 0, 15, 0, 0, 0, 3, 18
"d:\JS\light-store\src\app\modules\employees\components\product-selector\product-selector.component.html", "HTML", 0, 0, 5, 0, 0, 1, 6
"d:\JS\light-store\src\app\modules\employees\components\product-selector\product-selector.component.scss", "SCSS", 5, 0, 0, 0, 0, 1, 6
"d:\JS\light-store\src\app\modules\employees\components\product-selector\product-selector.component.ts", "TypeScript", 0, 37, 0, 0, 0, 8, 45
"d:\JS\light-store\src\app\modules\employees\components\products-adding-item\products-adding-item.component.html", "HTML", 0, 0, 5, 0, 0, 1, 6
"d:\JS\light-store\src\app\modules\employees\components\products-adding-item\products-adding-item.component.scss", "SCSS", 8, 0, 0, 0, 0, 3, 11
"d:\JS\light-store\src\app\modules\employees\components\products-adding-item\products-adding-item.component.ts", "TypeScript", 0, 14, 0, 0, 0, 3, 17
"d:\JS\light-store\src\app\modules\employees\components\products-adding-selector\products-adding-selector.component.html", "HTML", 0, 0, 9, 0, 0, 1, 10
"d:\JS\light-store\src\app\modules\employees\components\products-adding-selector\products-adding-selector.component.scss", "SCSS", 8, 0, 0, 0, 0, 3, 11
"d:\JS\light-store\src\app\modules\employees\components\products-adding-selector\products-adding-selector.component.ts", "TypeScript", 0, 27, 0, 0, 0, 7, 34
"d:\JS\light-store\src\app\modules\employees\employees-routing.module.ts", "TypeScript", 0, 30, 0, 0, 0, 6, 36
"d:\JS\light-store\src\app\modules\employees\employees.module.ts", "TypeScript", 0, 51, 0, 0, 0, 4, 55
"d:\JS\light-store\src\app\modules\employees\guards\employee.guard.ts", "TypeScript", 0, 20, 0, 0, 0, 4, 24
"d:\JS\light-store\src\app\modules\employees\models\dtos\create-product-dto.ts", "TypeScript", 0, 10, 0, 0, 0, 2, 12
"d:\JS\light-store\src\app\modules\employees\models\dtos\create-products-adding-dto.ts", "TypeScript", 0, 5, 0, 0, 0, 2, 7
"d:\JS\light-store\src\app\modules\employees\models\dtos\create-products-category-dto.ts", "TypeScript", 0, 4, 0, 0, 0, 1, 5
"d:\JS\light-store\src\app\modules\employees\models\dtos\product-in-adding-dto.ts", "TypeScript", 0, 4, 0, 0, 0, 1, 5
"d:\JS\light-store\src\app\modules\employees\models\dtos\update-product-dto.ts", "TypeScript", 0, 11, 0, 0, 0, 2, 13
"d:\JS\light-store\src\app\modules\employees\models\dtos\update-products-category-dto.ts", "TypeScript", 0, 5, 0, 0, 0, 1, 6
"d:\JS\light-store\src\app\modules\employees\models\employee.ts", "TypeScript", 0, 3, 0, 0, 0, 2, 5
"d:\JS\light-store\src\app\modules\employees\models\product-in-adding.ts", "TypeScript", 0, 6, 0, 0, 0, 1, 7
"d:\JS\light-store\src\app\modules\employees\models\products-adding-details.ts", "TypeScript", 0, 9, 0, 0, 0, 2, 11
"d:\JS\light-store\src\app\modules\employees\models\products-adding.ts", "TypeScript", 0, 8, 0, 0, 0, 2, 10
"d:\JS\light-store\src\app\modules\employees\pages\employee-base-layout\employee-base-layout.component.html", "HTML", 0, 0, 1, 0, 0, 1, 2
"d:\JS\light-store\src\app\modules\employees\pages\employee-base-layout\employee-base-layout.component.scss", "SCSS", 0, 0, 0, 0, 0, 1, 1
"d:\JS\light-store\src\app\modules\employees\pages\employee-base-layout\employee-base-layout.component.ts", "TypeScript", 0, 8, 0, 0, 0, 3, 11
"d:\JS\light-store\src\app\modules\employees\pages\employee-page\employee-page.component.html", "HTML", 0, 0, 9, 0, 0, 1, 10
"d:\JS\light-store\src\app\modules\employees\pages\employee-page\employee-page.component.scss", "SCSS", 0, 0, 0, 0, 0, 1, 1
"d:\JS\light-store\src\app\modules\employees\pages\employee-page\employee-page.component.ts", "TypeScript", 0, 14, 0, 0, 0, 2, 16
"d:\JS\light-store\src\app\modules\employees\services\employee.service.ts", "TypeScript", 0, 37, 0, 0, 0, 6, 43
"d:\JS\light-store\src\app\modules\employees\services\product.service.ts", "TypeScript", 0, 39, 0, 0, 0, 5, 44
"d:\JS\light-store\src\app\modules\employees\services\products-adding.service.ts", "TypeScript", 0, 38, 0, 0, 0, 5, 43
"d:\JS\light-store\src\app\modules\employees\services\products-category.service.ts", "TypeScript", 0, 46, 0, 0, 0, 6, 52
"d:\JS\light-store\src\app\modules\employees\tabs\orders-tab\orders-tab.component.html", "HTML", 0, 0, 1, 0, 0, 1, 2
"d:\JS\light-store\src\app\modules\employees\tabs\orders-tab\orders-tab.component.scss", "SCSS", 0, 0, 0, 0, 0, 1, 1
"d:\JS\light-store\src\app\modules\employees\tabs\orders-tab\orders-tab.component.ts", "TypeScript", 0, 8, 0, 0, 0, 3, 11
"d:\JS\light-store\src\app\modules\employees\tabs\product-editor-tab\product-editor-tab.component.html", "HTML", 0, 0, 67, 0, 0, 9, 76
"d:\JS\light-store\src\app\modules\employees\tabs\product-editor-tab\product-editor-tab.component.scss", "SCSS", 0, 0, 0, 0, 0, 1, 1
"d:\JS\light-store\src\app\modules\employees\tabs\product-editor-tab\product-editor-tab.component.ts", "TypeScript", 0, 144, 0, 0, 2, 22, 168
"d:\JS\light-store\src\app\modules\employees\tabs\products-adding-view-tab\products-adding-view-tab.component.html", "HTML", 0, 0, 18, 0, 0, 1, 19
"d:\JS\light-store\src\app\modules\employees\tabs\products-adding-view-tab\products-adding-view-tab.component.scss", "SCSS", 9, 0, 0, 0, 0, 2, 11
"d:\JS\light-store\src\app\modules\employees\tabs\products-adding-view-tab\products-adding-view-tab.component.ts", "TypeScript", 0, 26, 0, 0, 0, 5, 31
"d:\JS\light-store\src\app\modules\employees\tabs\products-addings-editor-tab\products-addings-editor-tab.component.html", "HTML", 0, 0, 22, 0, 0, 1, 23
"d:\JS\light-store\src\app\modules\employees\tabs\products-addings-editor-tab\products-addings-editor-tab.component.scss", "SCSS", 0, 0, 0, 0, 0, 1, 1
"d:\JS\light-store\src\app\modules\employees\tabs\products-addings-editor-tab\products-addings-editor-tab.component.ts", "TypeScript", 0, 75, 0, 0, 2, 16, 93
"d:\JS\light-store\src\app\modules\employees\tabs\products-addings-tab\products-addings-tab.component.html", "HTML", 0, 0, 6, 0, 0, 1, 7
"d:\JS\light-store\src\app\modules\employees\tabs\products-addings-tab\products-addings-tab.component.scss", "SCSS", 0, 0, 0, 0, 0, 1, 1
"d:\JS\light-store\src\app\modules\employees\tabs\products-addings-tab\products-addings-tab.component.ts", "TypeScript", 0, 18, 0, 0, 0, 4, 22
"d:\JS\light-store\src\app\modules\employees\tabs\products-categories-tab\products-categories-tab.component.html", "HTML", 0, 0, 8, 0, 0, 1, 9
"d:\JS\light-store\src\app\modules\employees\tabs\products-categories-tab\products-categories-tab.component.scss", "SCSS", 0, 0, 0, 0, 0, 1, 1
"d:\JS\light-store\src\app\modules\employees\tabs\products-categories-tab\products-categories-tab.component.ts", "TypeScript", 0, 31, 0, 0, 0, 9, 40
"d:\JS\light-store\src\app\modules\employees\tabs\products-category-editor-tab\products-category-editor-tab.component.html", "HTML", 0, 0, 40, 0, 0, 4, 44
"d:\JS\light-store\src\app\modules\employees\tabs\products-category-editor-tab\products-category-editor-tab.component.scss", "SCSS", 0, 0, 0, 0, 0, 1, 1
"d:\JS\light-store\src\app\modules\employees\tabs\products-category-editor-tab\products-category-editor-tab.component.ts", "TypeScript", 0, 93, 0, 0, 2, 16, 111
"d:\JS\light-store\src\app\modules\employees\tabs\products-tab\products-tab.component.html", "HTML", 0, 0, 5, 0, 0, 1, 6
"d:\JS\light-store\src\app\modules\employees\tabs\products-tab\products-tab.component.scss", "SCSS", 0, 0, 0, 0, 0, 1, 1
"d:\JS\light-store\src\app\modules\employees\tabs\products-tab\products-tab.component.ts", "TypeScript", 0, 18, 0, 0, 0, 4, 22
"d:\JS\light-store\src\app\modules\jwt\app-jwt.module.ts", "TypeScript", 0, 20, 0, 0, 0, 3, 23
"d:\JS\light-store\src\app\modules\shared\components\change-password\change-password.component.html", "HTML", 0, 0, 26, 0, 0, 4, 30
"d:\JS\light-store\src\app\modules\shared\components\change-password\change-password.component.scss", "SCSS", 0, 0, 0, 0, 0, 1, 1
"d:\JS\light-store\src\app\modules\shared\components\change-password\change-password.component.ts", "TypeScript", 0, 61, 0, 0, 2, 10, 73
"d:\JS\light-store\src\app\modules\shared\components\dropdown-label\dropdown-label.component.html", "HTML", 0, 0, 6, 0, 0, 1, 7
"d:\JS\light-store\src\app\modules\shared\components\dropdown-label\dropdown-label.component.scss", "SCSS", 13, 0, 0, 0, 0, 2, 15
"d:\JS\light-store\src\app\modules\shared\components\dropdown-label\dropdown-label.component.ts", "TypeScript", 0, 17, 0, 0, 0, 4, 21
"d:\JS\light-store\src\app\modules\shared\components\footer\footer.component.html", "HTML", 0, 0, 24, 0, 0, 1, 25
"d:\JS\light-store\src\app\modules\shared\components\footer\footer.component.scss", "SCSS", 23, 0, 0, 0, 0, 3, 26
"d:\JS\light-store\src\app\modules\shared\components\footer\footer.component.ts", "TypeScript", 0, 8, 0, 0, 0, 3, 11
"d:\JS\light-store\src\app\modules\shared\components\form-error\form-error.component.html", "HTML", 0, 0, 3, 0, 0, 1, 4
"d:\JS\light-store\src\app\modules\shared\components\form-error\form-error.component.scss", "SCSS", 0, 0, 0, 0, 0, 1, 1
"d:\JS\light-store\src\app\modules\shared\components\form-error\form-error.component.ts", "TypeScript", 0, 38, 0, 0, 0, 8, 46
"d:\JS\light-store\src\app\modules\shared\components\form-section\form-section.component.html", "HTML", 0, 0, 6, 0, 0, 1, 7
"d:\JS\light-store\src\app\modules\shared\components\form-section\form-section.component.scss", "SCSS", 0, 0, 0, 0, 0, 1, 1
"d:\JS\light-store\src\app\modules\shared\components\form-section\form-section.component.ts", "TypeScript", 0, 14, 0, 0, 0, 2, 16
"d:\JS\light-store\src\app\modules\shared\components\header\header.component.html", "HTML", 0, 0, 37, 0, 0, 1, 38
"d:\JS\light-store\src\app\modules\shared\components\header\header.component.scss", "SCSS", 6, 0, 0, 0, 0, 2, 8
"d:\JS\light-store\src\app\modules\shared\components\header\header.component.ts", "TypeScript", 0, 36, 0, 0, 0, 6, 42
"d:\JS\light-store\src\app\modules\shared\components\image-selector\image-selector.component.html", "HTML", 0, 0, 4, 0, 0, 1, 5
"d:\JS\light-store\src\app\modules\shared\components\image-selector\image-selector.component.scss", "SCSS", 0, 0, 0, 0, 0, 1, 1
"d:\JS\light-store\src\app\modules\shared\components\image-selector\image-selector.component.ts", "TypeScript", 0, 16, 0, 0, 0, 5, 21
"d:\JS\light-store\src\app\modules\shared\components\modal-accept\modal-accept.component.html", "HTML", 0, 0, 8, 0, 0, 1, 9
"d:\JS\light-store\src\app\modules\shared\components\modal-accept\modal-accept.component.scss", "SCSS", 0, 0, 0, 0, 0, 1, 1
"d:\JS\light-store\src\app\modules\shared\components\modal-accept\modal-accept.component.ts", "TypeScript", 0, 26, 0, 0, 0, 7, 33
"d:\JS\light-store\src\app\modules\shared\components\modal\modal.component.html", "HTML", 0, 0, 5, 0, 0, 1, 6
"d:\JS\light-store\src\app\modules\shared\components\modal\modal.component.scss", "SCSS", 16, 0, 0, 0, 0, 4, 20
"d:\JS\light-store\src\app\modules\shared\components\modal\modal.component.ts", "TypeScript", 0, 13, 0, 0, 0, 3, 16
"d:\JS\light-store\src\app\modules\shared\components\notification-container\notification-container.component.html", "HTML", 0, 0, 3, 0, 0, 1, 4
"d:\JS\light-store\src\app\modules\shared\components\notification-container\notification-container.component.scss", "SCSS", 5, 0, 0, 0, 0, 1, 6
"d:\JS\light-store\src\app\modules\shared\components\notification-container\notification-container.component.ts", "TypeScript", 0, 23, 0, 0, 0, 4, 27
"d:\JS\light-store\src\app\modules\shared\components\notification\notification.component.html", "HTML", 0, 0, 11, 0, 0, 1, 12
"d:\JS\light-store\src\app\modules\shared\components\notification\notification.component.scss", "SCSS", 32, 0, 0, 0, 0, 4, 36
"d:\JS\light-store\src\app\modules\shared\components\notification\notification.component.ts", "TypeScript", 0, 13, 0, 0, 0, 2, 15
"d:\JS\light-store\src\app\modules\shared\components\pagination-control\pagination-control.component.html", "HTML", 0, 0, 21, 0, 0, 1, 22
"d:\JS\light-store\src\app\modules\shared\components\pagination-control\pagination-control.component.scss", "SCSS", 40, 0, 0, 0, 0, 4, 44
"d:\JS\light-store\src\app\modules\shared\components\pagination-control\pagination-control.component.ts", "TypeScript", 0, 51, 0, 0, 0, 12, 63
"d:\JS\light-store\src\app\modules\shared\components\products-category-card\products-category-card.component.html", "HTML", 0, 0, 6, 0, 0, 1, 7
"d:\JS\light-store\src\app\modules\shared\components\products-category-card\products-category-card.component.scss", "SCSS", 17, 0, 0, 0, 0, 4, 21
"d:\JS\light-store\src\app\modules\shared\components\products-category-card\products-category-card.component.ts", "TypeScript", 0, 14, 0, 0, 0, 3, 17
"d:\JS\light-store\src\app\modules\shared\components\products-category-selector\products-category-selector.component.html", "HTML", 0, 0, 14, 0, 0, 1, 15
"d:\JS\light-store\src\app\modules\shared\components\products-category-selector\products-category-selector.component.scss", "SCSS", 24, 0, 0, 0, 0, 3, 27
"d:\JS\light-store\src\app\modules\shared\components\products-category-selector\products-category-selector.component.ts", "TypeScript", 0, 86, 0, 0, 0, 21, 107
"d:\JS\light-store\src\app\modules\shared\components\search\search.component.html", "HTML", 0, 0, 13, 0, 0, 1, 14
"d:\JS\light-store\src\app\modules\shared\components\search\search.component.scss", "SCSS", 43, 0, 0, 0, 0, 5, 48
"d:\JS\light-store\src\app\modules\shared\components\search\search.component.ts", "TypeScript", 0, 35, 0, 0, 0, 6, 41
"d:\JS\light-store\src\app\modules\shared\components\sidenav\sidenav.component.html", "HTML", 0, 0, 7, 0, 0, 1, 8
"d:\JS\light-store\src\app\modules\shared\components\sidenav\sidenav.component.scss", "SCSS", 18, 0, 0, 0, 0, 5, 23
"d:\JS\light-store\src\app\modules\shared\components\sidenav\sidenav.component.ts", "TypeScript", 0, 9, 0, 0, 0, 2, 11
"d:\JS\light-store\src\app\modules\shared\directives\only-number.directive.ts", "TypeScript", 0, 93, 0, 0, 1, 28, 122
"d:\JS\light-store\src\app\modules\shared\directives\phone-mask.directive.ts", "TypeScript", 0, 47, 0, 0, 0, 9, 56
"d:\JS\light-store\src\app\modules\shared\guards\guest.guard.ts", "TypeScript", 0, 19, 0, 0, 0, 5, 24
"d:\JS\light-store\src\app\modules\shared\models\dtos\auth-response-dto.ts", "TypeScript", 0, 5, 0, 0, 0, 2, 7
"d:\JS\light-store\src\app\modules\shared\models\dtos\change-password-dto.ts", "TypeScript", 0, 4, 0, 0, 0, 1, 5
"d:\JS\light-store\src\app\modules\shared\models\dtos\pagination-args.ts", "TypeScript", 0, 4, 0, 0, 0, 1, 5
"d:\JS\light-store\src\app\modules\shared\models\dtos\product-filter-args.ts", "TypeScript", 0, 4, 0, 0, 0, 1, 5
"d:\JS\light-store\src\app\modules\shared\models\dtos\product-items-page-dto.ts", "TypeScript", 0, 5, 0, 0, 0, 2, 7
"d:\JS\light-store\src\app\modules\shared\models\dtos\products-page-dto.ts", "TypeScript", 0, 5, 0, 0, 0, 2, 7
"d:\JS\light-store\src\app\modules\shared\models\notification-type.ts", "TypeScript", 0, 5, 0, 0, 0, 1, 6
"d:\JS\light-store\src\app\modules\shared\models\person.ts", "TypeScript", 0, 5, 0, 0, 0, 1, 6
"d:\JS\light-store\src\app\modules\shared\models\product-details.ts", "TypeScript", 0, 12, 0, 0, 0, 3, 15
"d:\JS\light-store\src\app\modules\shared\models\product-in-warehouse-minified.ts", "TypeScript", 0, 5, 0, 0, 0, 2, 7
"d:\JS\light-store\src\app\modules\shared\models\product-in-warehouse.ts", "TypeScript", 0, 5, 0, 0, 0, 2, 7
"d:\JS\light-store\src\app\modules\shared\models\product-item.ts", "TypeScript", 0, 8, 0, 0, 0, 2, 10
"d:\JS\light-store\src\app\modules\shared\models\product-remains-minified.ts", "TypeScript", 0, 5, 0, 0, 0, 2, 7
"d:\JS\light-store\src\app\modules\shared\models\product.ts", "TypeScript", 0, 4, 0, 0, 0, 2, 6
"d:\JS\light-store\src\app\modules\shared\models\products-category.ts", "TypeScript", 0, 7, 0, 0, 0, 1, 8
"d:\JS\light-store\src\app\modules\shared\models\unit-of-measure.ts", "TypeScript", 0, 5, 0, 0, 0, 1, 6
"d:\JS\light-store\src\app\modules\shared\models\user-role.ts", "TypeScript", 0, 5, 0, 0, 0, 1, 6
"d:\JS\light-store\src\app\modules\shared\models\user.ts", "TypeScript", 0, 6, 0, 0, 0, 2, 8
"d:\JS\light-store\src\app\modules\shared\models\warehouse-minified.ts", "TypeScript", 0, 4, 0, 0, 0, 1, 5
"d:\JS\light-store\src\app\modules\shared\models\warehouse.ts", "TypeScript", 0, 7, 0, 0, 0, 1, 8
"d:\JS\light-store\src\app\modules\shared\pages\auth-page\auth-page.component.html", "HTML", 0, 0, 23, 0, 0, 3, 26
"d:\JS\light-store\src\app\modules\shared\pages\auth-page\auth-page.component.scss", "SCSS", 4, 0, 0, 0, 0, 1, 5
"d:\JS\light-store\src\app\modules\shared\pages\auth-page\auth-page.component.ts", "TypeScript", 0, 65, 0, 0, 0, 9, 74
"d:\JS\light-store\src\app\modules\shared\pages\base-layout\base-layout.component.html", "HTML", 0, 0, 4, 0, 0, 1, 5
"d:\JS\light-store\src\app\modules\shared\pages\base-layout\base-layout.component.scss", "SCSS", 0, 0, 0, 0, 0, 1, 1
"d:\JS\light-store\src\app\modules\shared\pages\base-layout\base-layout.component.ts", "TypeScript", 0, 8, 0, 0, 0, 3, 11
"d:\JS\light-store\src\app\modules\shared\pages\info\agreement-page\agreement-page.component.html", "HTML", 0, 0, 14, 0, 0, 1, 15
"d:\JS\light-store\src\app\modules\shared\pages\info\agreement-page\agreement-page.component.ts", "TypeScript", 0, 8, 0, 0, 0, 3, 11
"d:\JS\light-store\src\app\modules\shared\pages\info\contacts-page\contacts-page.component.html", "HTML", 0, 0, 1, 0, 0, 1, 2
"d:\JS\light-store\src\app\modules\shared\pages\info\contacts-page\contacts-page.component.scss", "SCSS", 0, 0, 0, 0, 0, 1, 1
"d:\JS\light-store\src\app\modules\shared\pages\info\contacts-page\contacts-page.component.ts", "TypeScript", 0, 8, 0, 0, 0, 3, 11
"d:\JS\light-store\src\app\modules\shared\pages\info\exchange-refund-page\exchange-refund-page.component.html", "HTML", 0, 0, 13, 0, 0, 1, 14
"d:\JS\light-store\src\app\modules\shared\pages\info\exchange-refund-page\exchange-refund-page.component.ts", "TypeScript", 0, 8, 0, 0, 0, 3, 11
"d:\JS\light-store\src\app\modules\shared\pages\info\info-styles.scss", "SCSS", 20, 0, 0, 0, 0, 4, 24
"d:\JS\light-store\src\app\modules\shared\pages\info\privacy-policy-page\privacy-policy-page.component.html", "HTML", 0, 0, 159, 0, 1, 1, 161
"d:\JS\light-store\src\app\modules\shared\pages\info\privacy-policy-page\privacy-policy-page.component.ts", "TypeScript", 0, 8, 0, 0, 0, 3, 11
"d:\JS\light-store\src\app\modules\shared\pages\info\warranty-page\warranty-page.component.html", "HTML", 0, 0, 19, 0, 0, 1, 20
"d:\JS\light-store\src\app\modules\shared\pages\info\warranty-page\warranty-page.component.ts", "TypeScript", 0, 8, 0, 0, 0, 3, 11
"d:\JS\light-store\src\app\modules\shared\pipes\decl-by-num.pipe.ts", "TypeScript", 0, 18, 0, 0, 0, 7, 25
"d:\JS\light-store\src\app\modules\shared\pipes\local-date.pipe.ts", "TypeScript", 0, 11, 0, 0, 0, 3, 14
"d:\JS\light-store\src\app\modules\shared\pipes\person-full-name.pipe.ts", "TypeScript", 0, 12, 0, 0, 0, 3, 15
"d:\JS\light-store\src\app\modules\shared\pipes\phone-number.pipe.ts", "TypeScript", 0, 20, 0, 0, 0, 3, 23
"d:\JS\light-store\src\app\modules\shared\pipes\price.pipe.ts", "TypeScript", 0, 12, 0, 0, 0, 2, 14
"d:\JS\light-store\src\app\modules\shared\pipes\unit-of-measure.pipe.ts", "TypeScript", 0, 15, 0, 0, 0, 2, 17
"d:\JS\light-store\src\app\modules\shared\pipes\user-role.pipe.ts", "TypeScript", 0, 15, 0, 0, 0, 3, 18
"d:\JS\light-store\src\app\modules\shared\services\auth.service.ts", "TypeScript", 0, 87, 0, 0, 0, 12, 99
"d:\JS\light-store\src\app\modules\shared\services\base-http.service.ts", "TypeScript", 0, 22, 0, 0, 0, 5, 27
"d:\JS\light-store\src\app\modules\shared\services\error.service.ts", "TypeScript", 0, 31, 0, 0, 0, 6, 37
"d:\JS\light-store\src\app\modules\shared\services\product-get.service.ts", "TypeScript", 0, 60, 0, 0, 0, 6, 66
"d:\JS\light-store\src\app\modules\shared\services\product-in-warehouse.service.ts", "TypeScript", 0, 31, 0, 0, 0, 5, 36
"d:\JS\light-store\src\app\modules\shared\services\products-category.service.ts", "TypeScript", 0, 37, 0, 0, 0, 6, 43
"d:\JS\light-store\src\app\modules\shared\services\warehouse-get.service.ts", "TypeScript", 0, 24, 0, 0, 0, 4, 28
"d:\JS\light-store\src\app\modules\shared\shared-routing.module.ts", "TypeScript", 0, 8, 0, 0, 0, 3, 11
"d:\JS\light-store\src\app\modules\shared\shared.module.ts", "TypeScript", 0, 109, 0, 0, 0, 4, 113
"d:\JS\light-store\src\app\modules\shared\utils\math-utils.ts", "TypeScript", 0, 5, 0, 0, 0, 1, 6
"d:\JS\light-store\src\app\modules\shared\utils\parse-utils.ts", "TypeScript", 0, 6, 0, 0, 0, 3, 9
"d:\JS\light-store\src\app\modules\shared\validators\non-whitespace-validator.ts", "TypeScript", 0, 7, 0, 0, 0, 3, 10
"d:\JS\light-store\src\app\modules\shared\validators\non-wihitespace-or-null-validator.ts", "TypeScript", 0, 6, 0, 0, 0, 3, 9
"d:\JS\light-store\src\app\modules\shared\validators\phone-number.ts", "TypeScript", 0, 15, 0, 0, 0, 4, 19
"d:\JS\light-store\src\app\modules\shared\validators\predicate-validator.ts", "TypeScript", 0, 9, 0, 0, 0, 2, 11
"d:\JS\light-store\src\app\pages\notfound-page\notfound-page.component.html", "HTML", 0, 0, 1, 0, 0, 1, 2
"d:\JS\light-store\src\app\pages\notfound-page\notfound-page.component.scss", "SCSS", 0, 0, 0, 0, 0, 1, 1
"d:\JS\light-store\src\app\pages\notfound-page\notfound-page.component.ts", "TypeScript", 0, 8, 0, 0, 0, 3, 11
"d:\JS\light-store\src\app\template-title-strategy.ts", "TypeScript", 0, 15, 0, 0, 0, 3, 18
"d:\JS\light-store\src\assets\img\icons\cart_icon.svg", "XML", 0, 0, 0, 12, 0, 1, 13
"d:\JS\light-store\src\assets\img\icons\checkmark.svg", "XML", 0, 0, 0, 3, 0, 0, 3
"d:\JS\light-store\src\assets\img\icons\cross.svg", "XML", 0, 0, 0, 4, 0, 1, 5
"d:\JS\light-store\src\assets\img\icons\left_arrow.svg", "XML", 0, 0, 0, 43, 1, 1, 45
"d:\JS\light-store\src\assets\img\icons\minus.svg", "XML", 0, 0, 0, 3, 0, 1, 4
"d:\JS\light-store\src\assets\img\icons\plus.svg", "XML", 0, 0, 0, 4, 0, 1, 5
"d:\JS\light-store\src\assets\img\icons\search.svg", "XML", 0, 0, 0, 43, 1, 1, 45
"d:\JS\light-store\src\environments\environment-interface.ts", "TypeScript", 0, 5, 0, 0, 0, 1, 6
"d:\JS\light-store\src\environments\environment.ts", "TypeScript", 0, 7, 0, 0, 0, 3, 10
"d:\JS\light-store\src\index.html", "HTML", 0, 0, 13, 0, 0, 1, 14
"d:\JS\light-store\src\main.ts", "TypeScript", 0, 4, 0, 0, 0, 4, 8
"d:\JS\light-store\src\styles.scss", "SCSS", 421, 0, 0, 0, 0, 39, 460
"Total", "-", 1165, 4030, 1229, 112, 21, 1074, 7631